jpg	PICTURES
ai	PICTURES
bmp	PICTURES
gif	PICTURES
ico	PICTURES
jpeg	PICTURES
png 	PICTURES
ps 	PICTURES
psd 	PICTURES
svg 	PICTURES
tif	PICTURES
tiff	PICTURES
ods	DOCUMENTS
xlr	DOCUMENTS
xls	DOCUMENTS
xlsx	DOCUMENTS
doc	DOCUMENTS
docx	DOCUMENTS
pdf	DOCUMENTS
rtf	DOCUMENTS
tex	DOCUMENTS
txt	DOCUMENTS
wks	DOCUMENTS
wps	DOCUMENTS
wpd	DOCUMENTS
key	DOCUMENTS
odp	DOCUMENTS
pps	DOCUMENTS
ppt	DOCUMENTS
pptx	DOCUMENTS
